%%%%%%
% P  % 
%%%% %
%%.  %
%%%%%%
