%%%%%%%
%P    %
%     %
%     %
%    .%
%%%%%%%
