%%%%%%%
% P   %
% %%% %%%
% %   % %
% %%% % %
% G     %
%%%%%%%%%
