%%%%%%%
% P   %
% %%% %
% %%% %
% %%% %
% G   %
%%%%%%%
