%%%%%%%
%C P% %
% %%% %
% %.  %
% %%% %
%.    %
%     %
%     %
%    G%
%     %
%     %
%%%%%%%
